"a" = (/turf/stalker/floor/digable/grass,/area/stalker)
"b" = (/turf/simulated/wall/stalker/ship,/area/stalker/blowout/outdoor/safezone/bar)
"c" = (/obj/item/weapon/storage/backpack/polka{pixel_y = -8},/turf/simulated/wall/stalker/ship,/area/stalker/blowout/outdoor/safezone/bar)
"d" = (/turf/stalker/floor/lattice{icon_state = "lattice2_1"},/area/stalker/blowout/outdoor/safezone/bar)
"e" = (/obj/machinery/button{id = "GeneralSycDoor"; pixel_x = 24; pixel_y = -8; step_x = 1},/turf/stalker/floor/lattice{icon_state = "lattice2_1"},/area/stalker/blowout/outdoor/safezone/bar)
"f" = (/obj/structure/grille/stalker{icon_state = "fence3"},/turf/stalker/floor/lattice{icon_state = "lattice2_1"},/area/stalker/blowout/outdoor/safezone/bar)
"g" = (/obj/structure/bed/chair/wood/normal,/turf/stalker/floor/lattice{icon_state = "lattice2_1"},/area/stalker/blowout/outdoor/safezone/bar)
"h" = (/obj/machinery/door/poddoor/sidor{id = "GeneralSycDoor"},/turf/stalker/floor/lattice{icon_state = "lattice2_1"},/area/stalker/blowout/outdoor/safezone/bar)
"i" = (/obj/structure/table/stalker/wood/bar100rentgen{dir = 4; icon_state = "table"; pixel_x = 2},/turf/stalker/floor/lattice{icon_state = "lattice2_1"},/area/stalker/blowout/outdoor/safezone/bar)
"j" = (/obj/structure/table/stalker/wood,/turf/stalker/floor/lattice{icon_state = "lattice2_1"},/area/stalker/blowout/outdoor/safezone/bar)
"k" = (/obj/machinery/button{id = "SychExit1"; pixel_x = 24; pixel_y = -8},/turf/stalker/floor/lattice{icon_state = "lattice2_1"},/area/stalker/blowout/outdoor/safezone/bar)
"l" = (/obj/structure/table/stalker/wood,/obj/machinery/stalker/sidormat{name = "SYCHOMAT 2000"; pixel_y = 15},/turf/stalker/floor/lattice{icon_state = "lattice2_1"},/area/stalker/blowout/outdoor/safezone/bar)
"m" = (/obj/structure/grille/stalker,/turf/stalker/floor/lattice{icon_state = "lattice2_1"},/area/stalker/blowout/outdoor/safezone/bar)
"n" = (/obj/structure/grille/stalker{icon_state = "fence2"},/turf/stalker/floor/lattice{icon_state = "lattice2_1"},/area/stalker/blowout/outdoor/safezone/bar)
"o" = (/obj/machinery/button{id = "MechanicDoor"; pixel_x = 8; pixel_y = -24},/turf/stalker/floor/lattice{icon_state = "lattice2_1"},/area/stalker/blowout/outdoor/safezone/bar)
"p" = (/obj/machinery/door/poddoor/sidor{id = "SychExit1"},/turf/stalker/floor/lattice{icon_state = "lattice2_1"},/area/stalker/blowout/outdoor/safezone/bar)
"q" = (/obj/machinery/door/poddoor/sidor{id = "SychExit2"},/turf/stalker/floor/lattice{icon_state = "lattice2_1"},/area/stalker/blowout/outdoor/safezone/bar)
"r" = (/obj/structure/stalker/komod{pixel_x = 5; pixel_y = -3},/turf/stalker/floor/lattice{icon_state = "lattice2_1"},/area/stalker/blowout/outdoor/safezone/bar)
"s" = (/obj/structure/bed/stalker/metal/matras,/turf/stalker/floor/lattice{icon_state = "lattice2_1"},/area/stalker/blowout/outdoor/safezone/bar)
"t" = (/obj/machinery/door/poddoor/sidor{id = "MechanicDoor"},/turf/stalker/floor/lattice{icon_state = "lattice2_1"},/area/stalker/blowout/outdoor/safezone/bar)
"u" = (/obj/machinery/button{id = "SychExit2"; pixel_x = 24; pixel_y = 8},/turf/stalker/floor/lattice{icon_state = "lattice2_1"},/area/stalker/blowout/outdoor/safezone/bar)
"v" = (/obj/structure/stalker/komod,/turf/stalker/floor/lattice{icon_state = "lattice2_1"},/area/stalker/blowout/outdoor/safezone/bar)
"w" = (/turf/simulated/floor/plasteel/stairs/stalker{tag = "icon-ladder (EAST)"; icon_state = "ladder_left"; dir = 4},/area/stalker/blowout/outdoor/safezone/bar)
"x" = (/turf/simulated/floor/plasteel/stairs/stalker{tag = "icon-ladder (EAST)"; icon_state = "ladder_right"; dir = 4},/area/stalker/blowout/outdoor/safezone/bar)
"y" = (/obj/effect/step_trigger/teleporter,/turf/simulated/floor/plasteel/stairs/stalker{tag = "icon-ladder (EAST)"; icon_state = "ladder_right"; dir = 4},/area/stalker/blowout/outdoor/safezone/bar)
"z" = (/obj/structure/table/stalker/wood/bar100rentgen{dir = 4; icon_state = "table"; pixel_x = -6; tag = "icon-table (EAST)"},/turf/stalker/floor/lattice{icon_state = "lattice2_1"},/area/stalker/blowout/outdoor/safezone/bar)
"A" = (/obj/structure/stalker/doski/doski3,/turf/stalker/floor/lattice{icon_state = "lattice2_1"},/area/stalker/blowout/outdoor/safezone/bar)
"B" = (/obj/effect/step_trigger/teleporter,/turf/simulated/floor/plasteel/stairs/stalker{tag = "icon-ladder (EAST)"; icon_state = "ladder_left"; dir = 4},/area/stalker/blowout/outdoor/safezone/bar)
"C" = (/obj/structure/closet/stalker/shkaf,/turf/stalker/floor/lattice{icon_state = "lattice2_1"},/area/stalker/blowout/outdoor/safezone/bar)
"D" = (/obj/structure/stalker/doski/doski4,/turf/stalker/floor/lattice{icon_state = "lattice2_1"},/area/stalker/blowout/outdoor/safezone/bar)
"E" = (/obj/item/weapon/storage/backpack/polka{pixel_y = 15},/turf/stalker/floor/lattice{icon_state = "lattice2_1"},/area/stalker/blowout/outdoor/safezone/bar)
"F" = (/obj/structure/stalker/list,/turf/stalker/floor/lattice{icon_state = "lattice2_1"},/area/stalker/blowout/outdoor/safezone/bar)
"G" = (/obj/structure/closet/stalker/shkaf{pixel_x = 9},/turf/stalker/floor/lattice{icon_state = "lattice2_1"},/area/stalker/blowout/outdoor/safezone/bar)
"H" = (/obj/machinery/door/unpowered/stalker,/turf/stalker/floor/lattice{icon_state = "lattice2_1"},/area/stalker/blowout/outdoor/safezone/bar)
"I" = (/obj/structure/stalker/doski/doski2,/turf/stalker/floor/lattice{icon_state = "lattice2_1"},/area/stalker/blowout/outdoor/safezone/bar)
"J" = (/obj/structure/stalker/truba,/turf/stalker/floor/lattice{icon_state = "lattice2_1"},/area/stalker/blowout/outdoor/safezone/bar)
"K" = (/obj/structure/closet/stalker/shkaf{pixel_x = 9},/turf/stalker/floor/lattice{icon_state = "lattice2_1"},/area/stalker/blowout/outdoor/safezone/bar)
"L" = (/obj/structure/stalker/yashik/yaskik_a,/turf/stalker/floor/lattice{icon_state = "lattice2_1"},/area/stalker/blowout/outdoor/safezone/bar)
"M" = (/obj/structure/stalker/yashik,/turf/stalker/floor/lattice{icon_state = "lattice2_1"},/area/stalker/blowout/outdoor/safezone/bar)
"N" = (/obj/structure/stalker/komod{pixel_x = -4; step_x = 0},/turf/stalker/floor/lattice{icon_state = "lattice2_1"},/area/stalker/blowout/outdoor/safezone/bar)
"O" = (/obj/item/weapon/storage/backpack/polka{desc = "Деревный стеллаж. С боковой стороны кто-то вырезал слова: ''Петрович пидор!''"; dir = 4; icon_state = "polka"; pixel_x = 24; tag = "icon-polka (EAST)"},/turf/stalker/floor/lattice{icon_state = "lattice2_1"},/area/stalker/blowout/outdoor/safezone/bar)
"P" = (/obj/structure/bed/stalker/metal/matras{tag = "icon-krovat (EAST)"; icon_state = "krovat"; dir = 4},/turf/stalker/floor/lattice{icon_state = "lattice2_1"},/area/stalker/blowout/outdoor/safezone/bar)
"Q" = (/obj/structure/bed/stalker/metal{dir = 8; icon_state = "krovat_e"; pixel_x = -5; tag = "icon-krovat_e (WEST)"},/obj/structure/stalker/matras{pixel_x = 15; pixel_y = 5},/turf/stalker/floor/lattice{icon_state = "lattice2_1"},/area/stalker/blowout/outdoor/safezone/bar)
"R" = (/obj/structure/bed/stalker/metal/matras{tag = "icon-krovat (WEST)"; icon_state = "krovat"; dir = 8},/turf/stalker/floor/lattice{icon_state = "lattice2_1"},/area/stalker/blowout/outdoor/safezone/bar)
"S" = (/obj/structure/safe{desc = "Старый сейф. Кто-то выцарапал на нем слово:''Лопата''"; tumbler_1_open = 25; tumbler_1_pos = 26; tumbler_2_open = 27; tumbler_2_pos = 26},/turf/stalker/floor/lattice{icon_state = "lattice2_1"},/area/stalker/blowout/outdoor/safezone/bar)
"T" = (/obj/structure/closet/crate/stalker/blue,/turf/stalker/floor/lattice{icon_state = "lattice2_1"},/area/stalker/blowout/outdoor/safezone/bar)

(1,1,1) = {"
aaaaaaaaaaaaaaaaaaaaaaaaaaaaaaaaaaaaaaaaaaaaaaaaaaaaaaaaaaaaaaaaaaaaaaaaaaaaaaaaaaaaaaaaaaaaaaaaaaaa
aaaaaaaaaaaaaaaaaaaaaaaaaaaaaaaaaaaaaaaaaaaaaaaaaaaaaaaaaaaaaaaaaaaaaaaaaaaaaaaaaaaaaaaaaaaaaaaaaaaa
aaaaaaaaaaaaaaaaaaaaaaaaaaaaaaaaaaaaaaaaaaaaaaaaaaaaaaaaaaaaaaaaaaaaaaaaaaaaaaaaaaaaaaaaaaaaaaaaaaaa
aaaaaaaaaaaaaaaaaaaaaaaaaaaaaaaaaaaaaaaaaaaaaaaaaaaaaaaaaaaaaaaaaaaaaaaaaaaaaaaaaaaaaaaaaaaaaaaaaaaa
aaaaaaaaaaaaaaaaaaaaaaaaaaaaaaaaaaaaaaaaaaaaaaaaaaaaaaaaaaaaaaaaaaaaaaaaaaaaaaaaaaaaaaaaaaaaaaaaaaaa
aaaaaaaaaaaaaaaaaaaaaaaaaaaaaaaaaaaaaaaaaaaaaaaaaaaaaaaaaaaaaaaaaaaaaaaaaaaaaaaaaaaaaaaaaaaaaaaaaaaa
aaaaaaaaaaaaaaaaaaaaaaaaaaaaaaaaaaaaaaaaaaaaaaaaaaaaaaaaaaaaaaaaaaaaaaaaaaaaaaaaaaaaaaaaaaaaaaaaaaaa
aaaaaaaaaaaaaaaaaaaaaaaaaaaaaaaaaaaaaaaaaaaaaaaaaaaaaaaaaaaaaaaaaaaaaaaaaaaaaaaaaaaaaaaaaaaaaaaaaaaa
aaaaaaaaaaaaaaaaaaaaaaaaaaaaaaaaaaaaaaaaaaaaaaaaaaaaaaaaaaaaaaaaaaaaaaaaaaaaaaaaaaaaaaaaaaaaaaaaaaaa
aaaaaaaaaaaaaaaaaaaaaaaaaaaaaaaaaaaaaaaaaaaaaaaaaaaaaaaaaaaaaaaaaaaaaaaaaaaaaaaaaaaaaaaaaaaaaaaaaaaa
aaaaaaaaaaaaaaaaaaaaaaaaaaaaaaaaaaaaaaaaaaaaaaaaaaaaaaaaaaaaaaaaaaaaaaaaaaaaaaaaaaaaaaaaaaaaaaaaaaaa
aaaaaaaaaaaaaaaaaaaaaaaaaaaaaaaaaaaaaaaaaaaaaaaaaaaaaaaaaaaaaaaaaaaaaaaaaaaaaaaaaaaaaaaaaaaaaaaaaaaa
aaaaaaaaaaaaaaaaaaaaaaaaaaaaaaaaaaaaaaaaaaaaaaaaaaaaaaaaaaaaaaaaaaaaaaaaaaaaaaaaaaaaaaaaaaaaaaaaaaaa
aaaaaaaaaaaaaaaaaaaaaaaaaaaaaaaaaaaaaaaaaaaaaaaaaaaaaaaaaaaaaaaaaaaaaaaaaaaaaaaaaaaaaaaaaaaaaaaaaaaa
aaaaaaaaaaaaaaaaaaaaaaaaaaaaaaaaaaaaaaaaaaaaaaaaaaaaaaaaaaaaaaaaaaaaaaaaaaaaaaaaaaaaaaaaaaaaaaaaaaaa
aaaaaaaaaaaaaaaaaaaaaaaaaaaaaaaaaaaaaaaaaaaaaaaaaaaaaaaaaaaaaaaaaaaaaaaaaaaaaaaaaaaaaaaaaaaaaaaaaaaa
aaaaaaaaaaaaaaaaaaaaaaaaaaaaaaaaaaaaaaaaaaaaaaaaaaaaaaaaaaaaaaaaaaaaaaaaaaaaaaaaaaaaaaaaaaaaaaaaaaaa
aaaaaaaaaaaaaaaaaaaaaaaaaaaaaaaaaaaaaaaaaaaaaaaaaaaaaaaaaaaaaaaaaaaaaaaaaaaaaaaaaaaaaaaaaaaaaaaaaaaa
aaaaaaaaaaaaaaaaaaaaaaaaaaaaaaaaaaaaaaaaaaaaaaaaaaaaaaaaaaaaaaaaaaaaaaaaaaaaaaaaaaaaaaaaaaaaaaaaaaaa
aaaaaaaaaaaaaaaaaaaaaaaaaaaaaaaaaaaaaaaaaaaaaaaaaaaaaaaaaaaaaaaaaaaaaaaaaaaaaaaaaaaaaaaaaaaaaaaaaaaa
aaaaaaaaaaaaaaaaaaaaaaaaaaaaaaaaaaaaaaaaaaaaaaaaaaaaaaaaaaaaaaaaaaaaaaaaaaaaaaaaaaaaaaaaaaaaaaaaaaaa
aaaaaaaaaaaaaaaaaaaaaaaaaaaaaaaaaaaaaaaaaaaaaaaaaaaaaaaaaaaaaaaaaaaaaaaaaaaaaaaaaaaaaaaaaaaaaaaaaaaa
aaaaaaaaaaaaaaaaaaaaaaaaaaaaaaaaaaaaaaaaaaaaaaaaaaaaaaaaaaaaaaaaaaaaaaaaaaaaaaaaaaaaaaaaaaaaaaaaaaaa
aaaaaaaaaaaaaaaaaaaaaaaaaaaaaaaaaaaaaaaaaaaaaaaaaaaaaaaaaaaaaaaaaaaaaaaaaaaaaaaaaaaaaaaaaaaaaaaaaaaa
aaaaaaaaaaaaaaaaaaaaaaaaaaaaaaaaaaaaaaaaaaaaaaaaaaaaaaaaaaaaaaaaaaaaaaaaaaaaaaaaaaaaaaaaaaaaaaaaaaaa
aaaaaaaaaaaaaaaaaaaaaaaaaaaaaaaaaaaaaaaaaaaaaaaaaaaaaaaaaaaaaaaaaaaaaaaaaaaaaaaaaaaaaaaaaaaaaaaaaaaa
aaaaaaaaaaaaaaaaaaaaaaaaaaaaaaaaaaaaaaaaaaaaaaaaaaaaaaaaaaaaaaaaaaaaaaaaaaaaaaaaaaaaaaaaaaaaaaaaaaaa
aaaaaaaaaaaaaaaaaaaaaaaaaaaaaaaaaaaaaaaaaaaaaaaaaaaaaaaaaaaaaaaaaaaaaaaaaaaaaaaaaaaaaaaaaaaaaaaaaaaa
aaaaaaaaaaaaaaaaaaaaaaaaaaaaaaaaaaaaaaaaaaaaaaaaaaaaaaaaaaaaaaaaaaaaaaaaaaaaaaaaaaaaaaaaaaaaaaaaaaaa
aaaaaaaaaaaaaaaaaaaaaaaaaaaaaaaaaaaaaaaaaaaaaaaaaaaaaaaaaaaaaaaaaaaaaaaaaaaaaaaaaaaaaaaaaaaaaaaaaaaa
aaaaaaaaaaaaaaaaaaaaaaaaaaaaaaaaaaaaaaaaaaaaaaaaaaaaaaaaaaaaaaaaaaaaaaaaaaaaaaaaaaaaaaaaaaaaaaaaaaaa
aaaaaaaaaaaaaaaaaaaaaaaaaaaaaaaaaaaaaaaaaaaaaaaaaaaaaaaaaaaaaaaaaaaaaaaaaaaaaaaaaaaaaaaaaaaaaaaaaaaa
aaaaaaaaaaaaaaaaaaaaaaaaaaaaaaaaaaaaaaaaaaaaaaaaaaaaaaaaaaaaaaaaaaaaaaaaaaaaaaaaaaaaaaaaaaaaaaaaaaaa
aaaaaaaaaaaaaaaaaaaaaaaaaaaaaaaaaaaaaaaaaaaaaaaaaaaaaaaaaaaaaaaaaaaaaaaaaaaaaaaaaaaaaaaaaaaaaaaaaaaa
aaaaaaaaaaaaaaaaaaaaaaaaaaaaaaaaaaaaaaaaaaaaaaaaaaaaaaaaaaaaaaaaaaaaaaaaaaaaaaaaaaaaaaaaaaaaaaaaaaaa
aaaaaaaaaaaaaaaaaaaaaaaaaaaaaaaaaaaaaaaaaaaaaaaaaaaaaaaaaaaaaaaaaaaaaaaaaaaaaaaaaaaaaaaaaaaaaaaaaaaa
aaaaaaaaaaaaaaaaaaaaaaaaaaaaaaaaaaaaaaaaaaaaaaaaaaaaaaaaaaaaaaaaaaaaaaaaaaaaaaaaaaaaaaaaaaaaaaaaaaaa
aaaaaaaaaaaaaaaaaaaaaaaaaaaaaaaaaaaaaaaaaaaaaaaaaaaaaaaaaaaaaaaaaaaaaaaaaaaaaaaaaaaaaaaaaaaaaaaaaaaa
aaaaaaaaaaaaaaaaaaaaaaaaaaaaaaaaaaaaaaaaaaaaaaaaaaaaaaaaaaaaaaaaaaaaaaaaaaaaaaaaaaaaaaaaaaaaaaaaaaaa
aaaaaaaaaaaaaaaaaaaaaaaaaaaaaaaaaaaaaaaaaaaaaaaaaaaaaaaaaaaaaaaaaaaaaaaaaaaaaaaaaaaaaaaaaaaaaaaaaaaa
aaaaaaaaaaaaaaaaaaaaaaaaaaaaaaaaaaaaaaaaaaaaaaaaaaaaaaaaaaaaaaaaaaaaaaaaaaaaaaaaaaaaaaaaaaaaaaaaaaaa
aaaaaaaaaaaaaaaaaaaaaaaaaaaaaaaaaaaaaaaaaaaaaaaaaaaaaaaaaaaaaaaaaaaaaaaaaaaaaaaaaaaaaaaaaaaaaaaaaaaa
aaaaaaaaaaaaaaaaaaaaaaaaaaaaaaaaaaaaaaaaaaaaaaaaaaaaaaaaaaaaaaaaaaaaaaaaaaaaaaaaaaaaaaaaaaaaaaaaaaaa
aaaaaaaaaaaaaaaaaaaaaaaaaaaaaaaaaaaaaaaaaaaaaaaaaaaaaaaaaaaaaaaaaaaaaaaaaaaaaaaaaaaaaaaaaaaaaaaaaaaa
aaaaaaaaaaaaaaaaaaaaaaaaaaaaaaaaaaaaaaaaaaaaaaaaaaaaaaaaaaaaaaaaaaaaaaaaaaaaaaaaaaaaaaaaaaaaaaaaaaaa
aaaaaaaaaaaaaaaaaaaaaaaaaaaaaaaaaaaaaaaaaaaaaaaaaaaaaaaaaaaaaaaaaaaaaaaaaaaaaaaaaaaaaaaaaaaaaaaaaaaa
aaaaaaaaaaaaaaaaaaaaaaaaaaaaaaaaaaaaaaaaaaaaaaaaaaaaaaaaaaaaaaaaaaaaaaaaaaaaaaaaaaaaaaaaaaaaaaaaaaaa
aaaaaaaaaaaaaaaaaaaaaaaaaaaaaaaaaaaaaaaaaaaaaaaaaaaaaaaaaaaaaaaaaaaaaaaaaaaaaaaaaaaaaaaaaaaaaaaaaaaa
aaaaaaaaaaaaaaaaaaaaaaaaaaaaaaaaaaaaaaaaaaaaaaaaaaaaaaaaaaaaaaaaaaaaaaaaaaaaaaaaaaaaaaaaaaaaaaaaaaaa
aaaaaaaaaaaaaaaaaaaaaaaaaaaaaaaaaaaaaaaaaaaaaaaaaaaaaaaaaaaaaaaaaaaaaaaaaaaaaaaaaaaaaaaaaaaaaaaaaaaa
aaaaaaaaaaaaaaaaaaaaaaaaaaaaaaaaaaaaaaaaaaaaaaaaaaaaaaaaaaaaaaaaaaaaaaaaaaaaaaaaaaaaaaaaaaaaaaaaaaaa
aaaaaaaaaaaaaaaaaaaaaaaaaaaaaaaaaaaaaaaaaaaaaaaaaaaaaaaaaaaaaaaaaaaaaaaaaaaaaaaaaaaaaaaaaaaaaaaaaaaa
aaaaaaaaaaaaaaaaaaaaaaaaaaaaaaaaaaaaaaaaaaaaaaaaaaaaaaaaaaaaaaaaaaaaaaaaaaaaaaaaaaaaaaaaaaaaaaaaaaaa
aaaaaaaaaaaaaaaaaaaaaaaaaaaaaaaaaaaaaaaaaaaaaaaaaaaaaaaaaaaaaaaaaaaaaaaaaaaaaaaaaaaaaaaaaaaaaaaaaaaa
aaaaaaaaaaaaaaaaaaaaaaaaaaaaaaaaaaaaaaaaaaaaaaaaaaaaaaaaaaaaaaaaaaaaaaaaaaaaaaaaaaaaaaaaaaaaaaaaaaaa
aaaaaaaaaaaaaaaaaaaaaaaaaaaaaaaaaaaaaaaaaaaaaaaaaaaaaaaaaaaaaaaaaaaaaaaaaaaaaaaaaaaaaaaaaaaaaaaaaaaa
aaaaaaaaaaaaaaaaaaaaaaaaaaaaaaaaaaaaaaaaaaaaaaaaaaaaaaaaaaaaaaaaaaaaaaaaaaaaaaaaaaaaaaaaaaaaaaaaaaaa
aaaaaaaaaaaaaaaaaaaaaaaaaaaaaaaaaaaaaaaaaaaaaaaaaaaaaaaaaaaaaaaaaaaaaaaaaaaaaaaaaaaaaaaaaaaaaaaaaaaa
aaaaaaaaaaaaaaaaaaaaaaaaaaaaaaaaaaaaaaaaaaaaaaaaaaaaaaaaaaaaaaaaaaaaaaaaaaaaaaaaaaaaaaaaaaaaaaaaaaaa
aaaaaaaaaaaaaaaaaaaaaaaaaaaaaaaaaaaaaaaaaaaaaaaaaaaaaaaaaaaaaaaaaaaaaaaaaaaaaaaaaaaaaaaaaaaaaaaaaaaa
aaaaaaaaaaaaaaaaaaaaaaaaaaaaaaaaaaaaaaaaaaaaaaaaaaaaaaaaaaaaaaaaaaaaaaaaaaaaaaaaaaaaaaaaaaaaaaaaaaaa
aaaaaaaaaaaaaaaaaaaaaaaaaaaaaaaaaaaaaaaaaaaaaaaaaaaaaaaaaaaaaaaaaaaaaaaaaaaaaaaaaaaaaaaaaaaaaaaaaaaa
aaaaaaaaaaaaaaaaaaaaaaaaaaaaaaaaaaaaaaaaaaaaaaaaaaaaaaaaaaaaaaaaaaaaaaaaaaaaaaaaaaaaaaaaaaaaaaaaaaaa
aaaaaaaaaaaaaaaaaaaaaaaaaaaaaaaaaaaaaaaaaaaaaaaaaaaaaaaaaaaaaaaaaaaaaaaaaaaaaaaaaaaaaaaaaaaaaaaaaaaa
aaaaaaaaaaaaaaaaaaaaaaaaaaaaaaaaaaaaaaaaaaaaaaaaaaaaaaaaaaaaaaaaaaaaaaaaaaaaaaaaaaaaaaaaaaaaaaaaaaaa
aaaaaaaaaaaaaaaaaaaaaaaaaaaaaaaaaaaaaaaaaaaaaaaaaaaaaaaaaaaaaaaaaaaaaaaaaaaaaaaaaaaaaaaaaaaaaaaaaaaa
aaaaaaaaaaaaaaaaaaaaaaaaaaaaaaaaaaaaaaaaaaaaaaaaaaaaaaaaaaaaaaaaaaaaaaaaaaaaaaaaaaaaaaaaaaaaaaaaaaaa
aaaaaaaaaaaaaaaaaaaaaaaaaaaaaaaaaaaaaaaaaaaaaaaaaaaaaaaaaaaaaaaaaaaaaaaaaaaaaaaaaaaaaaaaaaaaaaaaaaaa
aaaaaaaaaaaaaaaaaaaaaaaaaaaaaaaaaaaaaaaaaaaaaaaaaaaaaaaaaaaaaaaaaaaaaaaaaaaaaaaaaaaaaaaaaaaaaaaaaaaa
aaaaaaaaaaaaaaaaaaaaaaaaaaaaaaaaaaaaaaaaaaaaaaaaaaaaaaaaaaaaaaaaaaaaaaaaaaaaaaaaaaaaaaaaaaaaaaaaaaaa
aaaaaaaaaaaaaaaaaaaaaaaaaaaaaaaaaaaaaaaaaaaaaaaaaaaaaaaaaaaaaaaaaaaaaaaaaaaaaaaaaaaaaaaaaaaaaaaaaaaa
aaaaaaaaaaaaaaaaaaaaaaaaaaaaaaaaaaaaaaaaaaaaaaaaaaaaaaaaaaaaaaaaaaaaaaaaaaaaaaaaaaaaaaaaaaaaaaaaaaaa
aaaaaaaaaaaaaaaaaaaaaaaaaaaaaaaaaaaaaaaaaaaaaaaaaaaaaaaaaaaaaaaaaaaaaaaaaaaaaaaaaaaaaaaaaaaaaaaaaaaa
aaaaaaaaaaaaaaaaaaaaaaaaaaaaaaaaaaaaaaaaaaaaaaaaaaaaaaaaaaaaaaaaaaaaaaaaaaaaaaaaaaaaaaaaaaaaaaaaaaaa
aaaaaaaaaaaaaaaaaaaaaaaaaaaaaaaaaaaaaaaaaaaaaaaaaaaaaaaaaaaaaaaaaaaaaaaaaaaaaaaaaaaaaaaaaaaaaaaaaaaa
aaaaaaaaaaaaaaaaaaaaaaaaaaaaaaaaaaaaaaaaaaaaaaaaaaaaaaaaaaaaaaaaaaaaaaaaaaaaaaaaaaaaaaaaaaaaaaaaaaaa
aaaaaaaaaaaaaaaaaaaaaaaaaaaaaaaaaaaaaaaaaaaaaaaaaaaaaaaaaaaaaaaaaaaaaaaaaaaaaaaaaaaaaaaaaaaaaaaaaaaa
aaaaaaaaaaaaaaaaaaaaaaaaaaaaaaaaaaaaaaaaaaaaaaaaaaaaaaaaaaaaaaaaaaaaaaaaaaaaaaaaaaaaaaaaaaaaaaaaaaaa
aaaaaaaaaaaaaaaaaaaaaaaaaaaaaaaaaaaaaaaaaaaaaaaaaaaaaaaaaaaaaaaaaaaaaaaaaaaaaaaaaaaaaaaaaaaaaaaaaaaa
aaaaaaaaaaaaaaaaaaaaaaaaaaaaaaaaaaaaaaaaaaaaaaaaaaaaaaaaaaaaaaaaaaaaaaaaaaaaaaaaaaaaaaaaaaaaaaaaaaaa
aaaaaaaaaaaaaaaaaaaaaaaaaaaaaaaaaaaaaaaaaaaaaaaaaaaaaaaaaaaaaaaaaaaaaaaaaaaaaaaaaaaaaaaaaaaaaaaaaaaa
aaaaaaaabbbbbbbbbbbbbbbbcbaaaaaaaaaaaaaaaaaaaaaaaaaaaaaaaaaaaaaaaaaaaaaaaaaaaaaaaaaaaaaaaaaaaaaaaaaa
aaaaaaaabdddddebdfddbdddgbaaaaaaaaaaaaaaaaaaaaaaaaaaaaaaaaaaaaaaaaaaaaaaaaaaaaaaaaaaaaaaaaaaaaaaaaaa
bbbbbbbbbddddddhdiddbdddjbaaaaaaaaaaaaaaaaaaaaaaaaaaaaaaaaaaaaaaaaaaaaaaaaaaaaaaaaaaaaaaaaaaaaaaaaaa
bddddddddddbbbbbdiddbbbddbaaaaaaaaaaaaaaaaaaaaaaaaaaaaaaaaaaaaaaaaaaaaaaaaaaaaaaaaaaaaaaaaaaaaaaaaaa
bdddddddddkbjljbmndddddddbaaaaaaaaaaaaaaaaaaaaaaaaaaaaaaaaaaaaaaaaaaaaaaaaaaaaaaaaaaaaaaaaaaaaaaaaaa
bdddddddoddpdddqddddbdbrsbaaaaaaaaaaaaaaaaaaaaaaaaaaaaaaaaaaaaaaaaaaaaaaaaaaaaaaaaaaaaaaaaaaaaaaaaaa
bddddddbbtbbddubdbbbbdbbbbaaaaaaaaaaaaaaaaaaaaaaaaaaaaaaaaaaaaaaaaaaaaaaaaaaaaaaaaaaaaaaaaaaaaaaaaaa
bddddddbvddbbbbbdbwwddxybaaaaaaaaaaaaaaaaaaaaaaaaaaaaaaaaaaaaaaaaaaaaaaaaaaaaaaaaaaaaaaaaaaaaaaaaaaa
bddddddbjgdzddbbddAdddwBbaaaaaaaaaaaaaaaaaaaaaaaaaaaaaaaaaaaaaaaaaaaaaaaaaaaaaaaaaaaaaaaaaaaaaaaaaaa
bddddddbCddbddddDbbbbdbbbbbaaaaaaaaaaaaaaaaaaaaaaaaaaaaaaaaaaaaaaaaaaaaaaaaaaaaaaaaaaaaaaaaaaaaaaaaa
bddddddbbbbbdbbbbbsvbdbEFGbaaaaaaaaaaaaaaaaaaaaaaaaaaaaaaaaaaaaaaaaaaaaaaaaaaaaaaaaaaaaaaaaaaaaaaaaa
bdddddddbddHddddIJdddddddKbaaaaaaaaaaaaaaaaaaaaaaaaaaaaaaaaaaaaaaaaaaaaaaaaaaaaaaaaaaaaaaaaaaaaaaaaa
bdddddddbddbLMbNddAdbdbddObaaaaaaaaaaaaaaaaaaaaaaaaaaaaaaaaaaaaaaaaaaaaaaaaaaaaaaaaaaaaaaaaaaaaaaaaa
bdddddddbddbbbbPdQdRbHbSTLbaaaaaaaaaaaaaaaaaaaaaaaaaaaaaaaaaaaaaaaaaaaaaaaaaaaaaaaaaaaaaaaaaaaaaaaaa
bbbbbbbbbbbbbbbbbbbbbbbbbbbaaaaaaaaaaaaaaaaaaaaaaaaaaaaaaaaaaaaaaaaaaaaaaaaaaaaaaaaaaaaaaaaaaaaaaaaa
aaaaaaaaaaaaaaaaaaaaaaaaaaaaaaaaaaaaaaaaaaaaaaaaaaaaaaaaaaaaaaaaaaaaaaaaaaaaaaaaaaaaaaaaaaaaaaaaaaaa
aaaaaaaaaaaaaaaaaaaaaaaaaaaaaaaaaaaaaaaaaaaaaaaaaaaaaaaaaaaaaaaaaaaaaaaaaaaaaaaaaaaaaaaaaaaaaaaaaaaa
aaaaaaaaaaaaaaaaaaaaaaaaaaaaaaaaaaaaaaaaaaaaaaaaaaaaaaaaaaaaaaaaaaaaaaaaaaaaaaaaaaaaaaaaaaaaaaaaaaaa
aaaaaaaaaaaaaaaaaaaaaaaaaaaaaaaaaaaaaaaaaaaaaaaaaaaaaaaaaaaaaaaaaaaaaaaaaaaaaaaaaaaaaaaaaaaaaaaaaaaa
"}
