"a" = (/turf/stalker/floor/digable/grass,/area/stalker/blowout/outdoor)
"b" = (/turf/simulated/wall/stalker/ship,/area/stalker/blowout/buildings/safezone)
"c" = (/turf/simulated/wall/stalker/ship,/area/stalker/blowout/outdoor)
"d" = (/turf/stalker/floor/lattice{icon_state = "lattice2_1"},/area/stalker/blowout/buildings/safezone)
"e" = (/obj/structure/stalker/shitok{pixel_x = -29},/turf/stalker/floor/lattice{icon_state = "lattice2_1"},/area/stalker/blowout/buildings/safezone)
"f" = (/obj/structure/table/stalker/wood,/turf/stalker/floor/lattice{icon_state = "lattice2_1"},/area/stalker/blowout/buildings/safezone)
"g" = (/obj/structure/table/stalker/wood/bar,/turf/stalker/floor/lattice{icon_state = "lattice2_1"},/area/stalker/blowout/buildings/safezone)
"h" = (/turf/stalker/floor/lattice{icon_state = "lattice2_1"},/area/stalker/blowout/outdoor)
"i" = (/turf/stalker/floor/sidor,/area/stalker/blowout/outdoor)
"j" = (/obj/machinery/door/unpowered/stalker,/turf/stalker/floor/lattice{icon_state = "lattice2_1"},/area/stalker/blowout/buildings/safezone)
"k" = (/obj/machinery/door/airlock/stalker,/turf/stalker/floor/lattice{icon_state = "lattice2_1"},/area/stalker/blowout/buildings/safezone)
"l" = (/turf/simulated/floor/plasteel/stairs/stalker{tag = "icon-ladder (EAST)"; icon_state = "ladder_right"; dir = 4},/area/stalker/blowout/buildings/safezone)
"m" = (/turf/simulated/floor/plasteel/stairs/stalker{tag = "icon-ladder (EAST)"; icon_state = "ladder_left"; dir = 4},/area/stalker/blowout/buildings/safezone)
"n" = (/obj/structure/grille/stalker,/turf/stalker/floor/lattice{icon_state = "lattice2_1"},/area/stalker/blowout/buildings/safezone)
"o" = (/obj/structure/grille/stalker{icon_state = "fence2"},/turf/stalker/floor/lattice{icon_state = "lattice2_1"},/area/stalker/blowout/buildings/safezone)
"p" = (/obj/structure/grille/stalker{icon_state = "fence3"},/turf/stalker/floor/lattice{icon_state = "lattice2_1"},/area/stalker/blowout/buildings/safezone)
"q" = (/obj/structure/stalker/truba,/turf/stalker/floor/lattice{icon_state = "lattice2_1"},/area/stalker/blowout/buildings/safezone)
"r" = (/obj/structure/stalker/bochka{pixel_x = -8; pixel_y = 10},/obj/structure/stalker/bochka,/turf/stalker/floor/lattice{icon_state = "lattice2_1"},/area/stalker/blowout/buildings/safezone)
"s" = (/obj/structure/stalker/bochka{pixel_y = 8},/turf/stalker/floor/lattice{icon_state = "lattice2_1"},/area/stalker/blowout/buildings/safezone)
"t" = (/obj/structure/stalker/yashik/yaskik_a,/turf/stalker/floor/lattice{icon_state = "lattice2_1"},/area/stalker/blowout/buildings/safezone)
"u" = (/obj/structure/stalker/yashik/yaskik_a/big,/turf/stalker/floor/lattice{icon_state = "lattice2_1"},/area/stalker/blowout/buildings/safezone)
"v" = (/obj/structure/stalker/doski/doski3,/turf/stalker/floor/lattice{icon_state = "lattice2_1"},/area/stalker/blowout/buildings/safezone)
"w" = (/obj/structure/bed/stalker/matras{pixel_y = 8},/turf/stalker/floor/lattice{icon_state = "lattice2_1"},/area/stalker/blowout/buildings/safezone)
"x" = (/obj/structure/stalker/shina2{pixel_x = 5; pixel_y = 14},/obj/structure/stalker/shina{pixel_x = -2},/turf/stalker/floor/lattice{icon_state = "lattice2_1"},/area/stalker/blowout/buildings/safezone)
"y" = (/obj/structure/stalker/list,/turf/stalker/floor/lattice{icon_state = "lattice2_1"},/area/stalker/blowout/buildings/safezone)
"z" = (/obj/machinery/door/poddoor/sidor{id = "SkadovskOut"},/turf/stalker/floor/lattice{icon_state = "lattice2_1"},/area/stalker/blowout/buildings/safezone)
"A" = (/obj/machinery/button{id = "SkadovskOut"; pixel_x = -4; pixel_y = 26},/turf/stalker/floor/lattice{icon_state = "lattice2_1"},/area/stalker/blowout/buildings/safezone)
"B" = (/obj/structure/stalker/doski/doski4,/turf/stalker/floor/lattice{icon_state = "lattice2_1"},/area/stalker/blowout/buildings/safezone)
"C" = (/obj/structure/stalker/truba/vert{pixel_x = -7},/turf/stalker/floor/lattice{icon_state = "lattice2_1"},/area/stalker/blowout/buildings/safezone)
"D" = (/obj/structure/bed/chair/stalker/divan{pixel_y = 2},/obj/structure/stalker/cover{pixel_y = 32},/turf/stalker/floor/lattice{icon_state = "lattice2_1"},/area/stalker/blowout/buildings/safezone)
"E" = (/obj/structure/bed/chair/stalker/divan/divan2{pixel_y = 2},/turf/stalker/floor/lattice{icon_state = "lattice2_1"},/area/stalker/blowout/buildings/safezone)
"F" = (/obj/structure/stalker/komod{pixel_x = -2; pixel_y = 3},/turf/stalker/floor/lattice{icon_state = "lattice2_1"},/area/stalker/blowout/buildings/safezone)
"G" = (/obj/item/weapon/storage/backpack/polka{pixel_y = 20},/turf/stalker/floor/lattice{icon_state = "lattice2_1"},/area/stalker/blowout/buildings/safezone)
"H" = (/obj/structure/stalker/doski/doski2,/turf/stalker/floor/lattice{icon_state = "lattice2_1"},/area/stalker/blowout/buildings/safezone)
"I" = (/obj/structure/stalker/clocks{pixel_x = -30; pixel_y = 5},/turf/stalker/floor/lattice{icon_state = "lattice2_1"},/area/stalker/blowout/buildings/safezone)
"J" = (/obj/structure/table/stalker/wood/bar100rentgen{dir = 4; icon_state = "table"; pixel_x = 2},/turf/stalker/floor/lattice{icon_state = "lattice2_1"},/area/stalker/blowout/buildings/safezone)
"K" = (/obj/machinery/door/poddoor/sidor{id = "SkadovskBar"},/turf/stalker/floor/lattice{icon_state = "lattice2_1"},/area/stalker/blowout/buildings/safezone)
"L" = (/obj/structure/table/stalker/wood/bar100rentgen{dir = 4; icon_state = "table"; pixel_x = 2},/turf/stalker/floor/lattice{icon_state = "lattice2_1"},/area/stalker/blowout/buildings/safezone)
"M" = (/obj/structure/stalker/brokenbed,/turf/stalker/floor/lattice{icon_state = "lattice2_1"},/area/stalker/blowout/buildings/safezone)
"N" = (/obj/machinery/button{id = "SkadovskBar"; pixel_x = 26; pixel_y = 8},/turf/stalker/floor/lattice{icon_state = "lattice2_1"},/area/stalker/blowout/buildings/safezone)
"O" = (/obj/structure/table/stalker/wood,/obj/structure/stalker/radio{dir = 4; icon_state = "radio"; pixel_x = -6; pixel_y = 6; tag = "icon-radio (EAST)"},/turf/stalker/floor/lattice{icon_state = "lattice2_1"},/area/stalker/blowout/buildings/safezone)
"P" = (/obj/structure/stalker/propane/dual{pixel_x = 7},/obj/structure/stalker/propane{pixel_x = 1},/obj/item/weapon/reagent_containers/food/snacks/stalker/konserva/fish{pixel_x = 4},/turf/stalker/floor/lattice{icon_state = "lattice2_1"},/area/stalker/blowout/buildings/safezone)

(1,1,1) = {"
aaaaaaaaaaaaaaaaaaaaaaaaaaaaaaaaaaaaaaaaaaaaaaaa
abbbbbbbbbbbbbbbbbbbbbbbbcccccaaaaaaaaaaaaaaaaaa
abdddbeddddddbrsffdggqtubhhhhhaaaaiiaaaaaaaaaaaa
abdddbeddddddbgddddvddwxjhhhhhhaaiiiicccaaaaaaaa
abdddbdddddddbgddddddddybhhhhhaaiiiiiiiiccaaaaaa
abdddbbzbbdddbddddffddffbhhhhhhaiiiiiiiiiiccaaaa
abdddbddAbllddddBdddddddbbhhhhhaaiiiiiiiiiiicaaa
abdddbdddbmmddddddddddddCkhhhhhaiiiiiiiiiiiiicaa
abdddbdddbbbbbnodddggdddbbhhhhaaiiiiiiiiiiiiiica
abdddbddddDEFbGpddddddHdubhhhhhaaiiiiiiiiiiiicaa
abdddbdddddddbIJddddddddtbhhhhhaiiiiiiiiiiiicaaa
abdddddddddddKdLdvdfddddMbhhhhaaaiiiiiiiiiccaaaa
abdddbddddddNbOpdddfddddPbhhhhaaiiiiiiiiccaaaaaa
abbbbbbbbbbbbbbbbbbbbbbbbbcccciaiiiiicccaaaaaaaa
aaaaaaaaaaaaaaaaaaaaaaaaaaaaaaaaaiiccaaaaaaaaaaa
aaaaaaaaaaaaaaaaaaaaaaaaaaaaaaaaaaaaaaaaaaaaaaaa
"}
