"a" = (/turf/stalker/floor/digable/grass,/area/stalker/blowout/outdoor)
"b" = (/turf/simulated/wall/stalker/ship,/area/stalker/blowout/buildings/safezone)
"c" = (/turf/simulated/wall/stalker/ship,/area/stalker/blowout/outdoor)
"d" = (/turf/stalker/floor/lattice{icon_state = "lattice2_1"},/area/stalker/blowout/buildings/safezone)
"e" = (/obj/structure/stalker/shitok{pixel_x = -29},/turf/stalker/floor/lattice{icon_state = "lattice2_1"},/area/stalker/blowout/buildings/safezone)
"f" = (/obj/structure/table/stalker/wood,/turf/stalker/floor/lattice{icon_state = "lattice2_1"},/area/stalker/blowout/buildings/safezone)
"g" = (/obj/structure/table/stalker/wood/bar,/turf/stalker/floor/lattice{icon_state = "lattice2_1"},/area/stalker/blowout/buildings/safezone)
"h" = (/turf/stalker/floor/lattice{icon_state = "lattice2_1"},/area/stalker/blowout/outdoor)
"i" = (/turf/stalker/floor/sidor,/area/stalker/blowout/outdoor)
"j" = (/obj/structure/table/stalker/wood/bar,/obj/structure/table/stalker/wood/bar{icon_state = "3-s"},/obj/structure/table/stalker/wood/bar{icon_state = "4-s"},/turf/stalker/floor/lattice{icon_state = "lattice2_1"},/area/stalker/blowout/buildings/safezone)
"k" = (/obj/structure/table/stalker/wood/bar,/obj/structure/table/stalker/wood/bar{icon_state = "2-n"},/obj/structure/table/stalker/wood/bar{icon_state = "1-n"},/turf/stalker/floor/lattice{icon_state = "lattice2_1"},/area/stalker/blowout/buildings/safezone)
"l" = (/turf/simulated/floor/plasteel/stairs/stalker{tag = "icon-ladder (EAST)"; icon_state = "ladder_right"; dir = 4},/area/stalker/blowout/buildings/safezone)
"m" = (/turf/simulated/floor/plasteel/stairs/stalker{tag = "icon-ladder (EAST)"; icon_state = "ladder_left"; dir = 4},/area/stalker/blowout/buildings/safezone)
"n" = (/obj/structure/grille/stalker,/turf/stalker/floor/lattice{icon_state = "lattice2_1"},/area/stalker/blowout/buildings/safezone)
"o" = (/obj/structure/grille/stalker{icon_state = "fence2"},/turf/stalker/floor/lattice{icon_state = "lattice2_1"},/area/stalker/blowout/buildings/safezone)
"p" = (/obj/structure/grille/stalker{icon_state = "fence3"},/turf/stalker/floor/lattice{icon_state = "lattice2_1"},/area/stalker/blowout/buildings/safezone)
"q" = (/obj/structure/stalker/truba,/turf/stalker/floor/lattice{icon_state = "lattice2_1"},/area/stalker/blowout/buildings/safezone)
"r" = (/obj/structure/table/stalker/wood/bar100rentgen{icon_state = "table"; dir = 4},/turf/stalker/floor/lattice{icon_state = "lattice2_1"},/area/stalker/blowout/buildings/safezone)

(1,1,1) = {"
aaaaaaaaaaaaaaaaaaaaaaaaaaaaaaaaaaaaaaaaaaaaaaaa
abbbbbbbbbbbbbbbbbbbbbbbbcccccaaaaaaaaaaaaaaaaaa
abdddbeddddddbddffdggdddbhhhhhaaaaiiaaaaaaaaaaaa
abdddbeddddddbjddddddddddhhhhhhaaiiiicccaaaaaaaa
abdddbdddddddbkdddddddddbhhhhhaaiiiiiiiiccaaaaaa
abdddbbdbbdddbddddffddffbhhhhhhaiiiiiiiiiiccaaaa
abdddbdddbllddddddddddddbbhhhhhaaiiiiiiiiiiicaaa
abdddbdddbmmddddddddddddddhhhhhaiiiiiiiiiiiiicaa
abdddbdddbbbbbnodddggdddbbhhhhaaiiiiiiiiiiiiiica
abdddbdddddddbdpddddddddqbhhhhhaaiiiiiiiiiiiicaa
abdddbdddddddbdrdddddddddbhhhhhaiiiiiiiiiiiicaaa
abdddddddddddddrdddfdddddbhhhhaaaiiiiiiiiiccaaaa
abdddbdddddddbdpdddfdddddbhhhhaaiiiiiiiiccaaaaaa
abbbbbbbbbbbbbbbbbbbbbbbbbcccciaiiiiicccaaaaaaaa
aaaaaaaaaaaaaaaaaaaaaaaaaaaaaaaaaiiccaaaaaaaaaaa
aaaaaaaaaaaaaaaaaaaaaaaaaaaaaaaaaaaaaaaaaaaaaaaa
"}
